1111111111111
1111111111111
1111111111111
11100N0000111
1110001100111
1111111111111
1111111111111